
NO ./textures/texture5.xpm
EA ./textures/texture2.xpm
SO ./textures/texture3.xpm
R    1300 855
WE ./textures/texture6.xpm
S./textures/sprite_1.xpm


C 200, 092,02
F 160,190,190

111111111111
1b111111111
11111111111
1100000001
1000000001
1S00000001
1111111111