NO ./textures/wall_1.xpm
EA ./textures/wood.xpm
SO ./textures/texture4.xpm
R  1111 900
WE ./textures/texture6.xpm
S ./textures/sprite_2.xpm

C 40, 45,90

F 160,190 ,190

1111111111111111111111111111111111
1111111111000000000000000000000001
1111000000000001001E00000000000001
110000000000000011000002000000000111111
111111111100000000000000000000000100001
111100000000000100100000000000000000001
110000000000000011000020000000000111111
1111111111000000000000000000000001011
111100000000000100100000000000001111
1100000000000000110000200000000001111
11111111111111111111111111111111111